0000000000000000
0000300000000000
0000000000000000
0000000000000000
0000000000#0#000
000$000000000*00
^0000000m0111111
1111122111111111
1111111111111111