0000000000030000
0000300000000000
0000000000000000
0000000000@00000
0000000000#0#000
000$000000000*00
^0000000m0222222
22222,,222111111
11111..111111111